XXXXXXXXXX
X0X   X FX
X X X X XX
X X X X XX
X X X X XX
X X X X XX
X X X X  X
X X X XX X
X   X    X
XXXXXXXXXX