XXXXXXXXXX
X0     X X
X     X XX
X     X XX
X     X XX
X     X XX
X F   X  X
X     XX X
X        X
XXXXXXXXXX